11 11
##########
#       E#
#  A     #
#     K  #
#        #
#S       #
####D#####
#        #
#   L    #
#        #
########## 