20 21
####################
#E          A#     #
####### ######     #
#     # #    #     #
#     #K#    #     #
#     #K#    #     #
#      K     D  A  #
#            #     #
#########D####D#####
#                 S#
#  A               #
#                  #
#  A               #
#                  #
#  A               #
#                  #
#          X       #
#                  #
#                  #
#################### 