11 11
##########
#E       #
#  KKKK  #
#       A#
#### #####
#       S#
#        #
#        #
#    L   #
#        #
########## 